00000000000000000333000000000000000000000000000000000000000000000
22001111100000000333000000000003300000000000000000000000000000000
22111111111000000333000000000003300000000000000000000030000000000
11111111111111111111111111111111111111111111111111111111111111111
11111111111111111111111111111111111111111111111111111111111111111