00000000000000000000000000000000000000000000000000000000000
00000000000000000000000000000000000000000000000000000000000
00000000000000000000000000000000000000000000000000000000000
11111111002220000000000330000000111111110000000000000000000
11111111002220000000300330111000000000000033300111111111111
11111111002220000000000000000000000000000033300000000000001
11111111000000111111111111111110000000000033300000000000001
11111111000111000011100000000001110000000000000000000000001
11111111111000000000011111111111111111111111111111111100001