11111111111111111111111111111111111111111111111111111111111111111111111111111111111111111111111111111111111111111111111111111111111111111111111111111111111111111111111111111111111111111111111111111111111111111111111111111111111111111111111111111111111111111111111111111111111111111111111
111111111111111111111111111111111110000000000001000010000000000000000010000000000001000000100000000000000000000000000000010000000000000000000000010000000000000000010000000000010000000000000000010000010000000000000000000000000000000000001
111111111111111111111111111111111110000000000001000010000000000000000010000000000001000000100000000000000000000000000000010000000000000000000000010000000000000000010000000000010000000000000000010000010000000000000000000000000000000000001
111111111111111111111111111111111110000000000001000010000000000000000010000000000001000000100000000000000000000000000000010000000000000000000000010000000000000000010000000000010000000000000000010000010000000000000000000000000000000000001
111111111111111111111111111111111110000000000001000010000000000000000010000000000001000000100000000000000000000000000000010000000000000000000000010000000000000000010000000000010000000000000000010000010000000000000000000000000000000000001
1111111111111111111111111111111111100000000000010000100000000000000000100000000000010000001000000000000000000000000000000100000000000000000000000100000000000000000100000000000100000000000000000100000100000000001111111000000000000000000000000001
111111111111111111111111111111111110000000000001000010000000000000000010000000000001000000100000000000000000000000000000010000000000000000000000010000000000000000010000000000010000000000000000010000010000000000000000000000000000000000001
111111111111111111111111111111111110000000000001000010000000000000000010000000000001000000100000000000000000000000000000010000000000000000000000010000000000000000010000000000010000000000000000010000010000000000000000000000000000000000001
111111111111111111111111111111111110000000000001000010000000000000000010000000000001000000100000000000000000000000000000010000000000000000000000010000000000000000010000000000010000000000000000010000010000000000000000000000000011111100000000001
111111111111111111111111111111111110000000000001000010000000000000000010000000000001000000100000000000000000000000000000010000000000000000000000010000000000000000010000000000010000000000000000010000010000000000000000000000000000000000001
11111111111111111111111111111111111000000000000100001000000000000000001000000000000100000010000000000000000000000000000001000000000000000000000001000000011110000000000100000000000100011110000000000000010000010000000000000000000000000000000000001
11111111111111111111111111111111111000000000000100001000000000000000001000000000000100000010000000000000000000000000000001000000000000000000000001000000000000000001000000000001000000000000000001000001000000011111000000000000000000000000000001
111111111111111111111111111111111110000000000001000010000000000000000010000000000001000000100000000000000000000000000000010000000000000000000000010000000000000000010000000000010000000000000000010000010000000000000000000000000000000000001
111111111111111111111111111111111110000000000000000000000000000000001000000000000100000010000000000000000000000000000001000000000000000000000001000000000010000001000000000000000000000000000000000000000000000000000010000000111111100000000001
1111111111111111111111111111111111100000000000000022000000000000000000000000000000000550000000000000000000000000440000000000000000000000000000000000000000044000000000000000000000000000004400000000000000000000000000000000000000000000000000000000000000000000000000000000000000000000000000000000001
111111111111111111111111111111111110000000000000002200000000000000000000000000000000055000000000000000000000000044000000000000000000000000000000000000000004400000000000000000000000000000440000000000000000000000000000000000000000000000000000000000000000000000000000000000000000000000000000000000001
1111111111111111111111111111111111100000000000000000000000000000000000000000000000000000000000000000000000000000000000000000000000000000000000000000000000000000000000000000000000000000000000000000000000000000000000000000000000000000000000000000000000000000000000000000000000000000000000001
11111111111111111111111111111111111111111111111111111111111111111111111111111111111111111111111111111111111111111111111111111111111111111111111111111111111111111111111111111111111111111111111111111111111111111111111111111111111111111111111111111111111111111111111111111111111111111111111
11111111111111111111111111111111111111111111111111111111111111111111111111111111111111111111111111111111111111111111111111111111111111111111111111111111111111111111111111111111111111111111111111111111111111111111111111111111111111111111111111111111111111111111111111111111111111111111111
11111111111111111111111111111111111111111111111111111111111111111111111111111111111111111111111111111111111111111111111111111111111111111111111111111111111111111111111111111111111111111111111111111111111111111111111111111111111111111111111111111111111111111111111111111111111111111111111
11111111111111111111111111111111111111111111111111111111111111111111111111111111111111111111111111111111111111111111111111111111111111111111111111111111111111111111111111111111111111111111111111111111111111111111111111111111111111111111111111111111111111111111111111111111111111111111111